  
	  NO		 ./path_to_the_north_texture  


  SO      ./path_to_the_south_texture 
    WE         ./path_to_the_west_texture
		EA 		./path_to_the_east_texture		

			F 			220,11,2
    C                           225,30,0

    1111111111111 11111111
    11000000001011100011111        
  111000011100111100101 10111
    11111111101  11111111111      
            101111            
111111111111101111111111111111111
10000000001110000111011111110000111111111
111101 1111 11101110000000000001001
11110111 11111011101010010001111111
110000011101010111000000100011
10000001 100000001100000010001
100000011100000011010100100011
11000011110111011111011110001
11110111 1111101 101111010001
11111111 111 111 111111111111