  
	 NO		 ./textures/no_tex.xpm

		EA 		./textures/ea_tex.xpm		
    WE         ./textures/we_tex.xpt
  SO    ./textures/so_tex.xpm

    C                           25,30,210
			F 			210,80,,,,,50

    111111111111 11111111
    11000000001011100011111        
  111000011100111100101 10111
    11111111101  11111111111      
            111111 
 
11111111111111111111111111111111    11111
10000010001110000111011111110000111111111
111101 1111 11101110000000000001001
11110111 11111011101010010101111111
1100000111010101110000010101                1
10000001 10000000110000011S111             101 1
1000000111000000110101001101011             1
11000011110111011111011111011
11110111 1111101 101111010001
11111111 111 111 11111111111