
	  NO		 ./textures/no_tex.xpm

		EA 		./textures/ea_tex.xpm		
    WE         ./textures/we_tex.xpm
  SO    ./textures/so_tex.xpm








F 245,230,,,,,,120


C 155,179,8




11111111111111111111111111111
10000000001100000000000000001
10110000011100000010000010001
10010000000000100000000010001
10110000011100000100000010011
10000000001100000111011110001
11110111111111011100000011001
11110111111111011101010010001
11000000110101011100000010001
10001000000000001100000010N01
10000000000000001101010010001
10000000000000001101010010001
11000000110101011111011110001
11110111111101011111011110001
11111111111111111111111111111
10010000000000011000000100001
10000000000000001101010010001
11111111111111111111111111111
        


