  
	  NO		 ../textures/path_to_the_north_texture 

		EA 		../textures/path_to_the_east_texture		
    WE         ../textures/path_to_the_west_texture
  SO    ../textures/path_to_the_south_texture 


  C 234,234,1
  F                     11,12,123                   
 
 
 
1111
1111     1
1001    101
1111     1
 
 
 
                        111111
                        110S11
                        111111
11
101
 1
 
 1
 
 
 111
 101
 11
      





